##############################
##############################
#            ##   ########   #
# ###### ##### ####       #  #
#     ##       #    ##### ####
#### ### ####### ## #   ##   #
#      #  ##    ## # #  #    #
### ####  #######  # #### ####
#      ##  B###    #    #    #
### ########### ####### ######
# # #   ##  #  #    #       ##
# # ### #### # ## ####### ####
# #            ## #    #     #
### ###### ## # ## ### # #####
#     ##    #           #    #
#### #### #### ####### ## # ##
#A    #          #     ##    #
##############################
