##############################
#            ##            ###
# ###### ##### ############ ##
#          # #        ##    ##
#### ####### # ######## ######
#           # #              #
### ######### ####### ###### #
#               ### #        #
### ####### ####### # ########
#   #   ##         # #      ##
# # ### ######## # # ### #####
# #   #    ##    # #   #     #
# ### #### ## ########## #####
#     ##    #B          #    #
#### #### #### ####### ## # ##
#A    #          #     ##    #
##############################
